16
16
30
2
0000000000000000
0000000000000000
0000000000000000
0000000000000000
0000000000000000
0000000000000000
0000000000000000
0000002220000000
0000002122000000
0000022212000000
0000021112000000
0000022222000000
0000000000000000
0000000000000000
0000000000000000
0000000000000000
